
F 160,85,45
C 0,191,255


NO ./texture/N.xpm
SO ./texture/S.xpm
WE ./texture/W.xpm
EA ./texture/E.xpm


111111111111111111111111111111
100000N00000000000000000000001
111111111111111111111111111111