
F 255,0,0

C 0,255,0


NO ./texture/bluestone.xpm
SO ./texture/redbrick.xpm
WE ./texture/purplestone.xpm
EA ./texture/greystone.xpm



        1111111111111111111111111
        1000000000110000000000001
        1011000001110000010000001
        1001000000000000100000001
1111111111011000001110000100000001
100000000011000001110111111111111
11110111111111011100000010001
11110111111111011101010010001
11000000110101011100000010001
10000001000E00001100000010001
1101001100000001101010010001
1100000111010101111101111000111
11110111 1110101 101111010001
11111111 1111111 111111111111
